1111111111111111111111111111111111111
1P0000C0C000000C00C0C0000C0C00C0CC001
1110000E00000011111111100000010C00111
1111110111100M00100001000001111111111
100000000C00C000000C000000C000000C001
100000000C00C00000000000C00000C00C001
111111100C00C00000000000000C0000CC001
100000100C00C000000000000C00000C00001
1111111000C00C000000000000000000C0001
10000C00000011111111100000000C000C001
1000C00000C01000000010000000000C00001
1111111111111111111111111111111111111