11111111111111111
1P0000C001E000011
1111000C000001011
11111111111111111