11111111111
1P1100C0001
1000000E001
1M00M000001
11111111111