1111111111111
100000P000C01
1001100010001
1110001111001
1000000000001
10000C000E101
1111111111111