111111111111111111111111111111
10P00C01C000000C001000C00100M1
11111001001011101011111101C101
1000C0010110110000111111010101
1011111100101100001000C0010101
10000C00000C110111100011110001
111M0001111111C00011000C000011
10C0000000C00100C0000000C000E1
111111111111111111111111111111